1111111111111
110P000000011
1000C00C0C001
10000000000E1
1111111111111